2 13 31
###############################
#p     ** *  1 *   *  * * *   #
# # # #*#   #*#*# # # #*#*#*# #
#   *     * *  *  1   * 1 * * #
# # # # # #*# # #*#*# # # # #*#
#            **  *  *   1   x #
# # # # # # # # # #*# #*# # # #
#*  *      *  *      *    2   #
# # # # #*# # # #*#*# # # # # #
#*    **  *       *           #
# #*#*# # # # # #*# # # # # # #
#     2     *  x*  *          #
###############################